3 3 3 3 3 3 3 3 3 3 3 3 3 3 3 3 3 3 3 3 3 3 3 3 3 3 3 3 3 3 3 3 3 3 3 3 3 3 3 3 3 3 3 3 3 3 3 3 3 3 
3 35 35 35 36 40 40 40 40 40 40 26 25 25 25 35 23 41 40 40 40 37 37 37 40 40 40 40 40 40 40 40 40 40 22 40 40 40 40 40 37 40 37 40 40 37 40 40 40 3
3 35 35 35 41 40 22 40 40 40 40 26 25 25 25 35 23 41 40 41 40 40 40 40 40 40 40 41 40 37 37 37 37 40 40 40 40 40 41 40 40 40 40 40 37 40 40 37 40 3 
3 35 35 35 36 40 40 40 40 40 40 26 25 25 25 35 23 40 40 37 37 37 37 41 37 37 37 37 40 37 40 40 40 37 37 37 37 41 41 37 37 37 41 40 40 40 37 40 40 3 
3 35 35 35 36 40 40 40 40 40 40 26 25 25 25 35 23 40 41 40 41 40 40 40 40 40 40 37 40 40 40 40 40 40 37 40 40 40 37 40 37 41 40 37 37 37 40 40 37 3
3 35 35 35 41 40 40 40 40 40 40 26 25 25 25 35 23 40 37 40 37 40 37 40 37 40 40 37 37 40 37 40 40 40 40 37 40 40 40 40 40 40 40 37 37 37 37 40 37 3
3 35 35 35 36 40 40 40 40 40 40 26 25 25 25 35 23 40 37 40 40 40 40 40 40 41 40 40 40 37 40 40 40 40 40 40 40 40 37 40 37 40 40 37 40 40 40 40 40 3 
3 35 35 35 36 40 40 40 40 40 40 26 25 25 25 35 23 37 37 37 37 37 40 40 24 41 41 40 40 40 37 40 40 40 40 40 37 40 40 37 40 40 40 40 40 40 40 37 40 3
3 35 35 35 41 40 40 40 22 40 40 26 25 25 25 35 23 37 37 37 37 40 40 40 40 40 41 41 41 40 40 41 40 24 40 40 37 37 40 40 40 37 40 40 40 40 40 40 40 3
3 35 35 35 41 40 40 40 40 40 40 26 25 25 25 35 23 37 37 37 40 40 40 40 40 40 40 41 41 41 40 40 37 41 37 40 40 40 40 40 40 40 37 40 40 40 40 41 40 3
3 35 35 35 36 40 40 40 40 40 40 26 25 25 25 35 23 37 37 40 40 40 40 40 40 40 38 41 36 41 40 40 37 41 37 40 40 39 40 40 40 40 22 40 40 40 37 40 40 3
3 35 35 35 36 40 40 40 40 40 40 27 29 29 29 28 23 37 40 40 40 22 40 37 24 40 40 37 41 40 40 37 40 40 37 37 41 37 37 41 40 40 40 37 40 37 40 40 40 3
3 35 35 35 41 23 23 23 40 23 23 40 40 40 40 40 40 40 40 40 40 40 40 40 40 40 40 37 37 41 40 40 40 40 40 40 40 40 40 40 41 40 40 40 40 40 40 37 40 3
3 35 35 35 41 40 23 23 40 23 23 40 40 40 40 40 40 36 36 36 36 36 36 36 36 36 36 36 36 36 36 36 36 36 41 40 37 40 24 40 40 37 40 40 37 40 37 40 40 3
3 35 35 35 41 40 23 23 40 23 23 40 40 40 40 40 40 25 25 25 25 25 25 25 25 25 25 25 25 25 25 25 25 25 40 40 40 40 41 40 40 40 37 40 40 40 40 37 40 3
3 35 35 35 36 40 23 23 40 23 23 40 40 40 40 40 40 25 25 25 25 25 25 25 25 25 25 25 25 25 25 25 25 25 40 40 41 37 40 40 40 41 35 35 35 40 40 40 40 3
3 35 35 35 36 40 23 23 40 23 23 40 40 40 40 40 40 25 25 25 25 25 25 25 25 25 25 25 25 25 25 25 25 25 40 37 40 40 37 40 40 41 35 35 35 40 40 40 37 3            
3 35 35 35 36 40 23 23 40 23 23 40 40 40 40 40 40 25 25 25 25 25 25 25 25 25 25 25 25 25 25 25 25 25 40 41 40 41 40 40 41 37 35 35 35 40 24 22 40 3
3 35 35 35 36 40 23 23 40 23 23 40 40 40 40 40 40 25 25 25 25 25 25 25 25 25 25 25 25 25 25 25 25 25 40 40 40 38 40 37 40 40 35 35 35 40 40 40 40 3
3 35 35 35 36 40 23 23 40 23 23 40 40 38 40 40 40 25 25 25 25 25 25 25 25 25 25 25 25 25 25 25 25 25 40 25 40 37 40 40 40 40 40 41 40 40 38 40 40 3
3 35 35 35 36 40 23 23 40 23 23 40 40 40 40 40 40 25 25 25 25 25 25 25 25 25 25 25 25 25 25 25 25 25 41 40 40 37 40 40 40 36 25 25 41 40 40 40 40 3
3 35 35 35 36 40 23 23 40 23 23 40 40 40 40 40 40 25 25 25 25 25 25 25 25 25 25 25 25 25 25 25 25 25 25 40 40 37 40 40 40 25 25 25 37 40 37 37 40 3
3 40 40 40 43 40 40 40 40 40 40 40 40 40 40 40 25 25 25 25 25 25 25 25 25 25 25 25 25 25 25 25 25 41 25 40 39 40 40 40 40 40 40 41 40 40 38 40 40 3
3 40 40 40 43 40 40 40 37 40 40 40 40 40 40 40 40 25 25 25 25 25 25 25 25 25 25 25 25 25 25 25 25 25 40 40 40 40 40 21 40 40 40 40 41 40 40 40 40 3
45 40 40 40 43 40 22 40 40 40 40 40 40 37 37 37 40 25 25 25 25 25 25 25 25 25 25 25 25 25 25 25 25 25 37 23 23 23 23 23 23 23 23 37 37 40 40 23 23 3 
45 40 40 40 43 40 40 40 21 40 40 40 37 37 37 37 40 25 25 25 25 25 25 25 25 25 25 25 25 25 25 25 25 25 40 40 40 40 40 40 37 37 40 40 40 40 40 41 41 3
3 40 40 40 43 40 40 40 40 40 40 40 40 37 37 37 40 25 25 25 25 25 25 25 25 25 25 25 25 25 25 25 25 25 24 40 40 37 37 40 37 40 40 37 37 40 41 35 41 3
3 40 40 40 43 40 40 40 37 40 40 40 40 40 37 37 40 25 25 25 25 25 25 25 25 25 25 25 25 25 25 25 25 25 40 40 37 37 37 40 40 40 40 37 40 40 40 35 35 3
3 35 35 35 36 40 22 22 23 22 22 40 40 40 40 37 40 25 25 25 25 25 25 25 25 25 25 25 25 25 25 25 25 25 40 22 37 37 37 40 40 40 37 40 40 37 40 40 40 3 
3 35 35 35 41 40 22 22 23 22 22 40 40 23 40 40 40 25 25 25 25 25 25 25 25 25 25 25 25 25 25 25 25 25 40 40 37 40 37 40 40 37 40 40 40 40 40 41 40 3
3 35 35 35 41 40 22 22 23 22 22 40 40 23 40 40 40 25 25 25 25 25 25 25 25 25 25 25 25 25 25 25 25 25 40 40 40 40 40 40 37 40 40 40 37 40 40 41 40 3
3 35 35 35 36 40 22 22 23 22 22 37 40 41 40 40 40 25 25 25 25 25 25 25 25 25 25 25 25 25 25 25 25 25 40 38 40 40 40 37 40 40 40 37 40 40 40 40 37 3
3 35 35 35 41 40 22 22 23 22 22 37 40 23 40 40 40 25 25 25 25 25 25 25 25 25 25 25 25 25 25 25 25 25 40 40 40 40 37 40 40 40 40 40 40 40 37 40 40 3
3 35 35 35 36 40 22 22 23 22 22 40 40 23 40 40 40 25 25 25 25 25 25 25 25 25 25 25 25 25 25 25 25 25 39 40 40 37 40 40 40 40 40 40 40 40 37 40 41 3
3 35 35 35 41 40 22 22 23 22 22 40 40 23 40 40 40 25 25 25 25 25 25 25 25 25 25 25 25 25 25 25 25 25 40 40 37 40 40 40 40 40 40 40 40 37 40 40 40 3
3 35 35 35 36 40 22 22 23 22 22 40 40 40 40 40 40 25 25 25 25 25 25 25 25 25 25 25 25 25 25 25 25 25 40 37 40 40 37 40 40 40 40 40 37 40 40 37 40 3
3 35 35 35 41 40 22 22 23 22 22 40 40 40 40 40 40 25 25 25 25 25 25 25 25 25 25 25 25 25 25 25 25 25 40 40 37 40 40 40 40 40 40 37 40 40 40 40 40 3
3 35 35 35 41 22 22 22 23 22 22 40 40 40 40 40 40 40 37 37 41 41 41 40 40 40 40 40 40 40 40 40 37 40 40 40 40 37 40 40 40 40 37 40 40 40 40 40 40 3
3 35 35 35 41 39 40 40 40 40 40 27 29 29 29 32 23 40 41 37 40 40 37 40 37 40 40 22 40 40 40 40 40 40 37 40 40 40 37 40 40 37 40 40 40 21 37 37 40 3
3 35 35 35 41 40 40 40 40 40 40 26 25 25 25 35 23 40 37 37 40 40 40 40 38 37 40 40 40 37 40 40 40 37 37 40 40 40 40 40 37 37 40 40 40 40 40 40 40 3
3 35 35 35 36 40 40 40 40 40 40 26 25 25 25 35 23 40 40 40 40 24 40 40 40 40 40 37 37 40 40 37 40 40 40 40 40 40 40 37 37 40 40 40 40 39 21 40 37 3 
3 35 35 35 36 40 40 40 40 40 40 26 25 25 25 35 23 40 37 38 37 40 40 39 40 21 40 37 40 40 22 40 37 40 37 40 40 40 37 37 40 40 37 40 38 40 40 40 40 3
3 35 35 35 36 40 40 40 40 40 40 26 25 25 25 35 23 40 39 37 40 40 22 40 40 38 40 37 40 40 40 40 37 40 40 40 40 41 40 37 37 40 40 40 40 40 40 37 40 3
3 35 35 35 41 40 40 40 40 40 40 26 25 25 25 35 23 40 37 40 40 40 40 37 40 40 40 40 40 40 40 40 40 40 37 37 37 40 40 40 40 40 37 40 40 40 37 40 40 3
3 35 35 35 41 40 40 40 40 40 40 26 25 25 25 35 23 40 37 40 37 40 37 40 40 40 40 40 40 40 40 37 40 40 40 37 40 40 40 41 40 40 40 40 40 37 37 40 40 3
3 35 35 35 41 40 40 40 40 40 40 26 25 25 25 35 23 40 40 37 40 40 40 40 40 21 40 37 40 37 37 37 40 40 41 40 40 37 40 37 41 40 37 37 40 40 40 24 40 3
3 35 35 35 36 40 40 40 40 40 40 26 25 25 25 35 23 40 37 40 37 40 37 37 37 40 40 40 37 37 40 40 40 37 40 40 37 40 40 40 40 40 37 37 40 40 22 40 40 3
3 35 35 35 36 40 40 40 40 40 40 26 25 25 25 35 23 40 37 22 40 37 40 40 40 41 38 40 37 40 37 24 40 37 40 41 40 40 22 24 40 37 40 40 40 37 40 40 40 3
3 35 35 35 41 40 40 40 40 40 40 26 25 25 25 35 23 40 40 40 40 40 40 37 40 40 40 40 40 40 40 40 40 40 40 40 37 40 40 40 40 40 40 40 37 40 40 40 37 3
3 3 3 3 3 3 3 3 3 3 3 3 3 3 3 3 3 3 3 3 3 3 3 3 3 3 3 3 3 3 3 3 3 3 3 3 3 3 3 3 3 3 3 3 3 3 3 3 3 3  
 


 23 : cây ( done )
 42 : cây chặt được( done)
 40 : Đất ( done)
 35 : magma ( done)
 25 : lửa (done )
 36 + 41 : đất giao magma ( đất phải) ( done)

 26 : lửa giao đất trái(done)
 29 : lửa giao đất dưới(done)
 35 : lửa giao đất phải(done)
 28 : 29 + 35(done)
 27 : 26 + 29(done)
 36 : lửa giao đất trên (done)
 40 : 26 + 36(done)
32 : 35 +36(done)
40 : cầu 
41 : cầu giao đất 
38: skull 1
39: skull 2
21 : bone 1
24 : dinosaur
22 :bone 3
37 : Rock
41 : lava rock
