3 3 3 3 3 3 3 3 3 3 3 3 3 3 3 3 3 3 3 3 3 3 3 3 3 3 3 3 3 3 3 3 3 3 3 3 3 3 3 3 3 3 3 3 3 3 3 3 3 3 
3 2 2 7 1 1 1 1 1 1 1 1 1 1 1 1 1 1 1 1 1 1 1 1 1 1 1 1 1 1 1 1 1 1 1 1 1 1 1 1 1 1 1 1 1 1 6 2 2 3
3 2 2 2 4 4 4 4 8 0 0 0 0 0 0 0 0 0 0 0 0 0 0 0 0 0 0 0 0 0 1 1 1 1 1 0 0 0 0 0 0 0 0 1 1 1 6 2 5 3
3 2 2 2 2 2 2 2 7 1 1 1 1 1 1 1 1 1 1 1 1 1 1 1 1 1 1 1 1 9 4 4 4 8 0 0 1 0 1 1 1 1 0 0 0 0 6 7 1 3
3 2 2 2 2 2 2 2 7 1 18 13 13 13 13 13 13 13 13 13 13 13 13 13 13 13 13 17 1 6 2 2 2 7 1 18 13 13 13 13 13 13 13 13 17 1 1 6 2 3
3 5 5 5 5 5 5 5 10 1 15 12 12 12 12 12 12 12 12 12 12 12 12 12 12 12 12 16 1 6 2 2 2 7 1 15 12 12 12 12 12 12 12 12 16 1 1 6 2 3
3 1 1 1 1 1 1 1 0 1 15 12 12 12 12 12 12 12 12 12 12 12 12 12 12 12 12 16 1 6 5 5 5 10 1 15 12 12 12 12 12 12 12 12 16 1 9 7 1 3
3 1 1 1 1 1 1 0 0 1 15 12 12 12 12 12 12 12 12 12 12 12 12 12 12 12 12 16 1 1 1 0 1 1 1 15 12 12 12 12 12 12 12 12 16 1 11 10 1 3
3 1 1 1 1 1 1 0 1 1 15 12 12 12 12 12 12 12 12 12 12 12 12 12 12 12 12 16 1 1 1 0 1 1 1 15 12 12 12 12 12 12 12 12 16 1 1 0 1 3
3 1 1 1 1 1 1 0 1 1 20 14 14 14 14 14 14 14 14 14 12 12 12 12 12 12 12 16 1 1 1 0 1 1 1 15 12 12 12 12 12 12 12 12 16 1 1 0 1 3
3 4 4 4 4 4 4 4 8 1 1 1 1 1 1 1 1 1 1 1 15 12 12 12 12 12 12 12 12 16 1 0 1 18 13 12 12 12 12 12 12 12 12 12 16 1 1 0 1 3
3 2 2 2 2 2 2 2 2 4 1 1 1 1 1 9 4 4 8 1 15 12 12 12 12 12 12 12 12 16 1 0 1 15 12 12 12 12 12 12 12 12 12 12 16 1 0 0 1 3
3 2 2 2 2 2 2 2 2 10 1 1 1 1 1 6 2 2 7 1 15 12 12 12 12 12 12 12 12 16 1 0 1 15 12 12 12 12 12 12 12 12 12 12 16 1 0 1 1 3
3 5 5 5 5 5 5 5 10 1 1 1 1 1 1 6 2 2 7 1 15 12 12 12 12 12 12 12 12 16 1 0 1 15 12 12 12 12 12 12 12 12 12 12 16 1 0 1 1 3
3 0 1 1 1 1 1 1 0 1 1 1 1 1 1 11 2 2 7 1 15 12 12 12 12 12 12 12 12 16 1 0 1 15 12 12 12 12 12 12 12 12 12 12 16 1 0 1 1 3
3 0 1 1 1 1 1 1 0 1 1 1 1 1 1 1 1 6 7 1 15 12 12 12 12 12 12 12 12 16 1 0 1 15 12 12 12 12 12 12 12 12 12 12 16 1 0 0 1 3
3 0 1 1 1 1 1 1 0 1 1 1 1 1 1 1 1 6 7 1 15 12 12 12 12 12 12 12 12 16 1 0 1 15 12 12 12 12 12 12 12 12 12 12 16 1 1 0 0 3
3 0 1 1 1 1 1 1 0 0 0 0 0 0 0 0 0 0 0 1 15 12 12 12 12 12 12 12 12 16 1 0 1 15 12 12 12 12 12 12 12 12 12 12 16 1 1 1 0 3
3 0 1 1 1 1 1 1 1 1 1 1 1 1 1 1 1 1 1 1 15 12 12 12 12 12 12 12 12 16 1 0 1 15 12 12 12 12 12 12 12 12 12 12 16 1 1 1 0 3
3 0 0 0 0 0 1 1 1 1 1 1 1 1 1 1 1 1 1 1 15 12 12 12 12 14 14 14 14 19 1 0 1 20 14 14 14 14 14 14 12 12 12 12 16 1 14 2 7 3
3 0 1 1 1 0 1 1 1 1 1 1 1 1 1 18 13 13 13 13 12 12 12 12 16 1 1 1 1 1 1 0 1 1 1 1 1 1 1 1 15 12 12 12 16 1 11 5 10 3
3 0 1 1 1 0 0 1 1 1 1 1 1 1 1 15 12 12 12 12 12 12 12 12 16 1 1 8 4 4 4 4 4 8 1 1 1 1 1 1 15 12 12 12 16 1 0 1 1 3
3 0 1 1 1 1 0 0 0 0 9 4 4 8 1 20 12 12 12 12 12 12 12 12 16 1 9 2 2 2 2 2 5 10 1 1 9 4 8 1 15 12 12 12 16 1 0 0 1 3
3 0 1 1 1 1 0 1 1 1 11 2 2 7 1 1 15 12 12 12 12 12 12 12 16 1 6 2 2 2 2 7 1 1 1 1 6 2 7 1 15 12 12 12 16 1 1 0 1 3
3 0 0 1 1 1 0 1 1 1 1 2 2 10 1 1 15 12 12 12 12 12 12 12 16 1 6 2 5 5 5 10 1 1 1 1 11 5 10 1 20 14 14 14 19 1 1 0 1 3
3 1 0 1 1 1 0 1 1 9 4 2 7 1 1 20 14 14 14 14 14 14 14 14 19 1 11 10 1 1 1 0 1 1 1 1 1 0 1 1 1 1 1 1 1 0 0 0 0 3
3 1 0 0 1 1 0 1 1 11 5 5 7 1 1 1 1 1 1 1 1 1 1 1 1 1 1 1 1 1 1 0 0 0 0 0 0 0 1 0 0 0 0 0 0 0 0 1 0 3
3 1 1 0 1 1 0 0 0 0 0 0 0 0 0 0 0 0 0 0 0 0 0 0 0 0 1 1 1 1 1 0 1 1 1 1 1 0 0 0 1 1 1 1 1 1 1 0 0 3
3 1 1 0 1 1 1 0 1 1 1 1 1 1 1 1 1 1 1 1 1 1 1 1 1 0 1 1 1 1 1 0 1 1 1 1 1 0 1 1 18 13 13 13 13 17 1 0 1 3
3 1 0 0 1 1 1 0 1 1 18 13 13 13 13 13 13 13 13 13 13 13 13 17 1 0 1 1 9 4 0 0 1 1 1 1 1 0 1 1 15 12 12 12 12 16 1 0 1 3
3 1 0 1 1 1 9 4 1 1 15 12 12 12 12 12 12 12 12 12 12 12 12 16 1 0 0 0 2 7 1 0 1 1 1 1 1 0 1 1 15 12 12 12 12 16 1 0 1 3
3 1 0 1 1 1 6 2 7 1 15 12 12 12 12 12 12 12 12 12 12 12 12 16 1 1 1 11 2 7 1 0 1 1 1 1 1 0 1 1 15 12 12 12 12 16 0 0 1 3
3 0 0 1 1 1 6 2 7 1 15 12 12 12 12 12 12 12 12 12 12 12 12 16 1 1 1 1 6 7 1 0 1 1 1 1 1 0 1 1 20 14 12 12 12 19 0 1 1 3
3 0 1 1 1 9 2 2 10 1 15 12 12 12 12 12 12 12 12 12 12 12 12 16 1 1 1 1 1 1 1 0 0 0 0 0 0 0 1 1 1 1 15 12 16 1 0 0 1 3
3 0 1 1 1 11 5 10 1 18 12 12 12 12 12 12 12 12 12 12 12 12 12 16 1 1 9 4 4 4 4 8 1 1 1 1 1 0 0 1 1 1 15 12 16 1 1 0 1 3
3 0 0 0 0 0 0 0 1 15 12 12 12 12 12 12 12 12 12 12 12 12 12 16 1 1 6 2 2 5 5 10 1 1 1 1 1 1 0 1 1 1 15 12 16 1 1 0 1 3
3 1 1 1 1 1 1 0 1 15 12 12 12 12 12 12 12 12 12 12 12 12 12 16 1 9 7 1 1 1 0 1 1 1 1 1 9 4 4 4 8 1 15 12 16 1 9 2 2 3
3 1 1 1 1 1 1 0 1 15 12 12 12 12 12 12 12 12 12 12 12 12 12 16 1 6 7 1 1 1 0 0 1 1 1 9 2 7 1 6 10 1 15 12 16 1 6 2 2 3
3 1 1 1 9 4 4 8 1 15 12 12 12 12 12 12 12 12 12 12 12 12 12 16 1 6 2 2 7 1 1 0 1 1 1 6 2 7 1 1 1 1 15 12 16 1 11 5 8 3
3 1 1 1 6 2 2 10 1 20 12 12 12 12 12 12 12 12 12 12 12 12 12 16 1 11 5 5 10 1 1 0 1 1 1 11 5 10 1 1 18 13 12 12 16 0 0 1 1 3
3 1 0 0 6 2 7 1 1 1 20 14 14 14 14 14 14 14 14 12 12 12 12 16 1 1 1 1 1 1 1 0 1 1 1 1 1 1 1 18 12 12 12 12 16 0 0 0 1 3
3 1 0 1 6 2 7 1 1 1 1 1 1 1 1 1 1 1 1 15 12 12 12 12 13 13 13 13 13 17 1 0 1 1 18 13 13 13 13 12 12 12 12 12 16 1 1 0 0 3
3 0 0 1 11 5 10 1 1 1 1 1 1 0 0 0 0 1 1 20 14 14 14 14 14 14 14 14 14 16 1 0 1 1 20 14 14 14 14 14 14 14 14 14 19 1 1 1 0 3
3 0 1 1 1 1 1 1 1 1 1 9 4 4 1 1 0 0 1 1 1 1 1 1 1 1 1 1 1 1 1 0 1 1 1 1 1 1 1 1 1 1 1 1 1 1 1 1 0 0
3 0 1 1 1 1 1 1 1 1 9 2 2 10 1 1 1 0 1 1 1 9 8 1 1 1 1 1 1 1 1 0 1 1 1 1 1 1 1 9 4 8 0 0 1 1 1 0 0 0
3 0 0 1 1 1 1 1 0 0 6 2 7 1 1 1 1 0 0 0 1 6 2 8 0 0 1 1 1 1 0 0 1 0 0 0 1 1 9 2 2 7 1 0 0 1 1 0 0 3
3 1 0 1 9 8 1 1 0 1 11 2 7 1 1 1 1 0 1 0 0 11 2 2 1 0 0 0 1 0 0 1 1 0 1 0 1 1 6 2 2 2 8 1 0 1 1 0 1 3
3 1 9 4 2 7 1 1 0 1 1 11 10 1 0 0 0 0 1 1 1 1 11 5 5 10 1 0 0 0 0 0 1 0 1 0 0 0 11 5 5 5 10 1 0 0 0 0 1 3
3 4 2 2 2 7 0 0 0 1 1 1 0 0 0 1 1 1 1 1 1 1 1 1 1 1 1 1 1 1 1 0 0 0 1 1 0 0 1 1 1 1 1 1 1 1 1 1 1 3
3 3 3 3 3 3 3 3 3 3 3 3 3 3 3 3 3 3 3 3 3 3 3 3 3 3 3 3 3 3 3 3 3 3 3 3 3 3 3 3 3 3 3 3 3 3 3 3 3 3